50 50
0 1 2 3 7 12 11 12 13 17 14 13 13 19 22 21 16 13 11 9 7 6 8 11 12 19 16 15 15 14 9 11 9 11 13 8 7 7 10 9 7 6 5 4 4 4 5 6 5 6 
2 5 7 10 13 14 18 17 16 16 20 16 17 29 27 26 20 18 17 11 10 8 12 20 21 21 23 22 18 14 13 10 12 12 13 14 12 12 10 10 10 10 9 7 7 7 11 9 7 4 
4 8 11 13 17 15 17 18 19 20 17 20 21 28 29 20 25 19 16 11 9 9 15 22 27 28 27 27 20 14 13 12 12 14 14 15 14 13 15 11 15 11 10 9 8 13 11 11 6 4 
9 10 11 12 14 16 16 19 22 17 17 16 22 26 28 20 27 21 14 10 10 11 14 20 29 30 22 29 25 18 12 10 16 14 17 17 15 16 13 14 15 15 14 11 10 11 11 6 4 5 
11 12 13 14 15 15 18 19 22 22 19 21 20 21 24 27 27 20 14 11 9 10 13 18 26 22 30 29 27 21 13 9 11 15 17 17 15 11 15 13 13 15 15 12 10 11 11 8 5 4 
11 12 14 13 11 13 17 20 22 22 22 21 22 22 22 22 22 20 17 14 14 16 15 23 26 29 29 29 24 21 15 11 14 16 16 13 10 9 10 15 15 15 14 13 15 13 14 12 9 6 
8 12 14 13 11 12 17 17 21 21 21 22 20 23 19 20 21 21 16 15 17 18 20 20 29 26 28 29 22 19 17 15 16 17 17 11 9 9 11 15 14 11 11 14 14 15 16 14 18 9 
6 13 13 14 10 13 18 19 21 21 21 22 25 22 19 17 16 18 17 18 18 21 20 21 23 29 26 26 24 19 17 17 17 18 16 10 8 11 16 15 13 11 10 11 16 15 16 18 16 12 
5 11 14 13 11 13 15 16 16 21 21 23 23 23 20 19 16 19 23 20 18 19 19 19 25 26 27 27 22 19 17 17 19 18 16 10 11 15 17 16 11 8 6 7 10 14 16 15 15 10 
4 8 14 14 11 12 10 15 15 18 21 21 22 23 20 20 20 24 23 22 19 18 19 19 21 25 27 27 22 20 19 17 17 17 13 12 15 19 18 17 15 11 9 7 9 13 14 14 9 6 
6 11 11 11 10 10 11 13 14 15 20 20 20 21 21 24 19 18 23 20 18 16 16 18 19 21 23 22 23 25 20 20 16 18 19 18 18 21 18 15 17 17 14 14 13 14 13 8 6 3 
9 13 13 12 10 11 10 12 11 14 14 16 13 14 17 23 24 23 19 17 14 19 15 18 20 19 17 20 24 25 20 15 16 20 20 21 21 19 16 15 18 20 20 19 19 16 10 4 3 2 
8 15 15 14 11 12 10 9 11 14 10 10 11 12 17 23 22 19 19 16 12 12 15 16 16 14 13 19 21 20 16 14 16 21 17 17 17 18 11 10 13 16 21 23 20 16 10 4 3 1 
8 14 17 19 18 14 13 13 11 11 11 7 6 12 19 19 19 18 15 16 12 11 14 14 14 13 15 17 19 16 14 13 15 21 17 17 17 18 11 8 10 11 19 21 23 18 15 10 7 3 
8 13 17 19 19 18 15 12 13 13 11 7 6 9 16 17 19 18 16 14 16 12 12 13 13 14 14 15 15 14 11 11 14 15 21 20 20 16 10 9 9 10 17 19 20 20 19 14 13 3 
9 14 15 19 19 19 15 11 16 16 14 11 11 13 15 22 20 22 20 19 15 12 13 14 16 16 16 15 13 12 13 13 11 13 15 18 17 15 15 11 10 9 19 20 23 23 22 16 11 3 
11 13 14 18 15 18 16 13 14 16 16 17 17 15 19 18 22 21 21 19 17 14 14 16 16 19 18 16 12 10 11 11 11 14 16 16 17 17 15 15 12 14 18 20 23 23 25 17 9 1 
10 10 14 15 14 17 15 12 13 16 14 19 17 17 16 19 19 22 20 18 17 12 14 16 15 19 18 18 16 13 11 11 14 16 16 15 17 15 15 15 15 14 16 18 22 25 24 16 8 1 
8 10 9 8 9 10 13 11 13 17 18 17 16 14 19 14 16 18 18 17 16 13 12 17 19 19 17 18 19 14 11 10 13 16 16 17 16 12 14 16 17 16 17 19 21 25 22 14 9 4 
6 8 9 9 7 8 7 10 14 18 18 14 12 13 14 15 13 15 16 12 12 11 12 12 14 15 18 16 15 15 14 14 13 19 19 17 15 12 15 17 20 17 20 18 18 18 16 13 12 7 
7 9 9 11 11 9 9 11 17 16 17 14 14 13 15 16 17 18 16 17 17 16 18 14 14 15 17 16 15 13 16 16 14 16 19 18 13 12 13 17 19 22 21 20 16 15 14 15 11 7 
9 10 11 15 14 12 11 14 15 15 16 17 17 13 13 14 19 19 16 17 18 18 19 14 13 17 17 17 14 16 18 18 16 18 16 19 16 14 17 20 26 24 23 20 15 15 18 12 9 4 
8 11 15 13 13 14 13 14 13 12 15 15 15 14 11 14 16 19 20 21 22 22 19 18 20 21 22 20 19 18 20 19 20 16 14 16 21 19 19 18 18 18 23 17 16 19 18 14 7 3 
7 12 14 14 14 15 15 13 14 14 14 13 14 10 11 9 12 18 19 21 22 21 19 20 21 25 25 24 21 20 20 21 16 14 12 13 15 17 21 22 18 24 18 14 20 19 17 10 7 3 
8 10 13 14 15 15 15 14 12 10 11 13 11 10 10 12 13 17 18 22 22 20 19 20 24 25 27 25 21 20 20 19 17 15 15 12 12 16 15 19 21 23 19 16 18 19 14 8 6 3 
8 12 12 14 16 12 13 14 11 8 8 11 13 12 15 19 17 18 17 21 17 16 18 23 23 27 25 24 20 19 19 19 17 17 14 14 13 11 14 14 17 20 23 20 21 21 18 11 7 7 
9 13 16 16 16 16 13 10 13 10 7 9 11 17 19 18 18 17 18 17 16 18 22 22 23 24 18 16 14 15 17 18 19 17 15 17 13 11 11 14 14 16 20 24 23 22 20 15 10 8 
12 14 17 16 16 14 13 10 9 12 11 11 12 18 17 17 14 15 16 12 13 17 19 21 21 16 13 13 10 11 14 19 20 20 18 14 17 15 14 16 17 15 21 26 25 24 21 16 14 12 
15 17 17 17 14 13 12 11 9 10 13 13 14 13 16 15 15 12 12 14 13 17 16 23 16 15 11 8 8 9 15 16 20 19 18 18 16 16 17 17 17 18 20 24 26 26 20 16 14 14 
17 22 20 18 15 16 13 12 10 11 10 14 11 13 12 15 14 11 11 13 11 14 14 12 12 13 7 3 5 7 10 13 16 18 20 18 16 14 16 17 18 18 21 25 28 26 22 16 14 13 
17 23 24 21 18 17 16 17 13 11 12 10 12 8 10 12 14 12 11 10 9 11 9 7 8 9 5 3 3 7 10 10 13 16 18 19 15 12 13 15 18 20 23 28 23 23 23 18 16 10 
20 25 26 26 21 18 17 17 14 14 13 14 12 9 8 10 11 13 11 12 6 4 3 2 3 5 3 2 5 8 10 9 11 15 18 18 17 15 13 15 17 23 24 24 23 24 22 19 17 8 
17 25 26 26 21 18 18 17 16 15 15 16 16 14 10 8 12 12 13 10 6 2 2 2 4 7 7 8 8 12 10 11 11 14 15 16 19 16 16 15 23 22 23 25 24 24 24 21 15 5 
14 25 24 25 20 20 16 17 16 17 14 14 14 16 10 7 11 13 12 11 6 3 4 7 6 10 17 12 12 11 12 13 17 15 14 16 19 23 19 19 19 21 23 24 23 23 26 23 13 4 
12 16 19 21 24 17 16 14 15 17 17 17 14 14 10 5 9 11 13 10 6 5 7 8 10 15 14 17 13 14 10 13 19 18 16 16 19 19 20 20 20 20 22 24 24 24 24 21 14 6 
10 14 18 19 17 16 14 13 14 17 17 15 15 14 10 7 7 8 11 9 7 8 11 14 19 18 17 17 17 14 14 13 15 21 19 19 16 16 16 18 19 19 19 23 25 24 25 20 15 10 
5 10 15 16 14 12 15 10 12 12 14 13 14 11 10 6 5 5 6 9 8 10 15 17 18 18 16 15 16 15 11 10 14 19 16 21 19 14 14 17 17 19 22 24 27 26 22 22 16 9 
6 10 11 14 13 11 9 13 12 15 14 16 13 12 10 5 2 2 4 5 7 10 15 19 18 17 15 13 15 15 8 7 13 18 15 16 18 14 10 13 16 19 22 26 26 26 27 24 16 9 
10 14 14 16 17 14 14 17 18 17 18 14 13 13 6 3 1 1 3 8 8 11 12 14 15 16 14 14 10 12 12 13 13 16 20 20 19 12 9 11 14 17 22 19 23 20 27 25 18 12 
11 21 23 20 20 16 18 20 18 22 18 15 11 8 5 3 3 3 5 8 11 12 12 11 11 16 17 14 11 10 13 13 13 15 16 17 12 12 10 14 13 14 16 18 21 20 24 23 23 10 
13 20 18 24 23 23 22 24 27 23 21 14 10 7 5 4 4 6 8 12 13 17 15 9 8 11 12 13 9 11 11 14 16 16 17 13 10 10 14 13 15 15 16 17 19 21 21 22 17 13 
10 18 23 24 24 23 24 27 28 28 21 17 11 8 8 5 5 7 11 13 15 17 15 16 11 14 15 15 13 11 14 14 20 19 19 16 14 13 12 13 16 15 18 17 15 19 19 19 16 12 
7 11 16 24 24 24 24 25 32 29 26 17 11 7 6 6 6 9 11 14 16 14 17 16 15 15 17 16 16 15 15 16 18 20 19 19 19 16 13 14 16 18 17 15 15 18 18 18 17 9 
2 6 8 12 17 24 25 28 29 24 28 19 11 9 6 8 11 9 10 13 14 16 16 16 15 17 16 17 17 17 15 15 18 18 19 18 16 16 15 15 15 16 16 15 15 18 18 15 12 7 
2 4 5 8 11 19 28 29 31 32 27 20 12 9 11 9 8 11 11 10 14 16 16 16 15 15 14 14 18 18 18 19 18 18 18 17 16 15 15 15 16 16 16 16 16 17 18 12 9 6 
6 7 8 13 15 22 30 32 30 30 24 20 14 13 10 9 8 11 8 7 10 16 16 15 12 13 13 15 13 16 17 18 19 17 15 14 14 15 15 16 19 20 17 17 17 14 9 9 6 4 
9 15 14 15 19 28 30 32 32 29 23 19 15 14 10 9 11 8 8 9 14 16 14 12 12 13 16 14 11 13 15 16 18 18 13 13 14 13 15 17 19 21 16 18 15 11 7 5 8 4 
12 15 15 18 18 26 29 30 32 30 22 21 14 11 10 12 10 10 10 14 15 14 12 11 11 13 13 13 12 15 17 16 15 16 13 13 12 13 16 18 18 21 16 21 14 10 7 6 5 4 
13 18 16 18 18 21 27 28 24 22 20 17 11 9 10 8 8 9 12 12 13 12 12 10 8 11 11 13 12 15 14 12 12 16 12 8 5 8 10 10 14 19 21 21 16 8 8 8 5 3 
10 14 16 15 18 19 22 20 16 16 15 14 8 8 5 5 6 10 9 12 9 10 11 8 7 10 11 9 9 10 8 7 8 8 8 5 3 5 5 5 10 16 16 20 12 8 5 8 4 2 
