40 40
4 6 11 9 9 6 8 8 7 5 5 4 5 6 8 8 8 6 4 2 2 3 5 8 10 10 12 16 18 16 16 12 10 14 14 11 9 12 12 7 
5 9 11 16 12 11 8 11 7 6 5 4 5 8 14 17 12 12 12 9 5 9 11 13 14 13 16 21 22 15 18 15 12 14 13 13 11 13 12 7 
9 9 13 14 16 12 8 5 6 5 3 4 8 11 16 16 17 17 19 13 9 13 14 13 15 15 14 18 15 23 21 15 15 14 13 13 14 12 10 6 
7 11 13 16 15 12 8 3 2 2 2 4 11 18 19 21 23 25 20 17 19 17 16 19 15 15 14 17 20 19 17 15 14 15 12 12 11 9 7 3 
7 9 15 15 14 10 7 4 4 4 4 7 14 20 21 23 18 23 22 20 17 18 19 15 15 12 13 15 15 16 16 14 16 12 16 13 11 9 5 2 
9 14 14 15 14 9 8 5 7 7 7 8 19 21 23 25 24 21 23 22 19 19 17 15 15 14 13 17 23 21 19 19 16 16 16 17 15 9 4 1 
9 17 15 14 11 10 10 6 7 9 9 15 18 24 24 24 20 16 17 19 19 17 18 12 16 17 18 21 23 23 23 19 18 17 19 19 14 11 4 1 
8 11 17 15 14 11 12 9 8 10 12 11 17 20 25 22 17 14 15 16 20 20 14 12 15 20 21 23 23 24 20 20 21 21 15 19 12 8 6 1 
7 11 15 18 17 16 15 16 14 14 14 12 15 18 24 18 14 9 12 18 17 15 13 10 15 17 17 23 21 19 18 18 18 21 21 16 12 7 4 3 
8 11 16 18 23 22 24 20 19 19 16 14 13 14 13 14 15 10 13 17 17 12 10 9 13 17 19 21 20 17 18 15 15 19 15 13 9 6 4 4 
6 13 14 20 23 24 23 24 22 22 17 14 11 11 9 8 9 11 12 14 13 10 6 8 13 15 15 17 20 15 11 14 13 12 11 10 7 7 9 7 
6 11 18 23 24 24 24 24 18 21 19 11 10 9 7 6 7 9 16 14 17 12 9 11 12 13 14 14 16 15 11 10 14 13 12 10 11 13 15 12 
5 11 18 22 23 22 18 22 23 22 18 15 12 10 7 7 7 8 12 14 13 15 14 15 15 16 16 14 14 13 12 10 12 13 13 11 15 20 21 18 
6 12 18 21 22 20 19 18 20 19 20 19 19 13 11 8 10 10 13 12 12 14 17 18 17 17 16 16 14 13 12 11 12 13 12 12 16 15 24 19 
9 14 20 22 22 23 18 18 16 16 21 21 22 18 13 12 15 15 10 5 7 13 17 15 19 17 19 16 17 14 10 14 15 13 13 13 16 15 15 20 
14 21 23 25 23 21 22 17 15 15 21 21 23 22 17 16 16 16 10 5 6 12 19 19 21 19 19 17 16 16 13 13 15 15 15 17 18 18 18 17 
19 24 26 26 23 23 18 19 20 16 18 21 23 23 22 20 19 19 9 4 5 10 15 17 19 15 18 17 16 17 18 14 13 15 17 19 19 17 13 12 
20 26 26 25 26 20 20 20 20 20 18 19 21 23 23 24 19 17 10 6 7 10 13 17 18 16 15 12 15 18 15 15 13 13 17 19 17 14 9 5 
25 23 24 24 20 23 19 21 20 20 20 23 26 26 27 23 19 16 15 10 13 14 17 17 13 11 13 12 13 19 16 17 13 15 16 16 13 12 6 1 
20 27 26 25 24 20 23 22 20 19 20 21 27 26 24 23 17 16 14 13 15 19 17 16 10 7 8 13 13 15 16 15 13 13 14 13 12 8 5 2 
15 26 26 26 23 20 21 22 17 19 19 27 27 26 23 19 17 16 19 14 15 14 17 12 9 5 6 12 16 17 16 14 11 12 9 9 10 9 7 4 
13 18 26 20 21 23 20 17 17 21 23 25 25 24 20 19 17 18 16 12 12 10 8 10 6 4 6 9 14 19 15 13 11 9 8 9 10 12 9 7 
6 15 21 25 27 24 18 15 13 21 25 25 25 23 19 17 20 15 12 11 11 8 6 6 7 5 7 10 13 14 13 13 11 14 14 15 13 13 18 8 
4 11 18 26 24 22 17 16 14 16 23 19 25 23 18 19 19 15 12 12 9 7 5 5 6 8 9 13 14 12 11 12 13 15 23 18 17 16 14 12 
4 10 17 24 22 21 17 17 19 15 20 22 23 21 21 21 18 14 12 12 12 9 7 9 13 17 19 16 16 13 7 9 13 20 20 23 19 17 16 13 
7 10 15 21 21 19 16 14 11 12 14 15 18 20 21 21 18 16 12 12 12 10 9 12 20 25 22 22 19 17 11 12 16 16 22 21 22 18 17 14 
8 13 16 17 21 15 11 10 10 9 10 15 15 15 17 17 20 17 13 12 11 12 13 15 20 24 25 25 20 18 17 16 15 15 16 19 20 23 17 13 
11 16 15 15 15 12 10 10 9 10 12 13 12 13 12 14 16 17 15 13 12 12 14 16 19 24 25 22 22 19 18 17 15 15 15 17 20 23 23 14 
13 15 17 15 14 10 11 12 10 15 12 10 11 10 11 8 11 14 17 16 16 15 14 17 18 20 21 24 19 20 18 15 14 12 16 20 21 23 22 18 
13 16 17 15 12 13 15 13 16 13 12 11 10 11 10 9 9 12 14 16 19 18 15 15 18 15 15 17 18 18 15 12 12 11 16 20 22 21 21 15 
12 13 13 15 13 12 13 14 16 14 13 12 10 11 11 8 10 10 13 14 17 19 17 18 17 16 16 16 18 16 16 12 16 14 16 16 20 18 16 10 
10 13 15 15 13 16 16 16 16 16 17 12 11 12 12 9 10 10 10 11 14 17 17 15 14 14 16 18 16 16 15 18 18 19 15 12 12 14 13 7 
8 11 13 15 13 14 18 18 18 15 16 19 16 15 14 10 10 10 12 11 13 14 17 15 15 13 18 18 18 18 19 20 20 17 14 10 8 8 8 5 
10 10 13 14 12 13 17 15 18 14 16 20 15 19 15 13 13 16 17 17 14 16 17 16 14 15 16 19 19 21 21 21 19 18 13 8 6 7 6 3 
7 13 11 10 11 16 18 18 18 17 18 20 15 21 16 13 18 20 21 17 17 15 19 16 16 15 18 19 19 16 21 19 18 18 11 8 6 6 5 2 
7 10 12 11 11 15 15 17 16 17 20 20 20 18 17 16 21 23 21 21 15 17 19 20 17 17 16 20 18 19 18 18 20 15 12 10 9 6 4 2 
6 9 13 14 13 16 17 17 17 18 19 16 17 13 16 16 23 21 21 19 19 14 18 16 15 17 15 15 18 18 18 20 16 17 16 14 13 8 4 2 
6 8 11 14 16 17 17 17 17 15 15 19 16 12 13 16 15 18 18 18 13 12 12 14 14 13 11 10 10 18 17 10 11 15 18 16 13 8 8 2 
8 7 9 15 14 16 14 17 11 14 11 13 16 15 9 7 6 9 12 9 11 13 11 9 9 8 9 8 7 10 10 6 8 14 18 16 10 8 4 2 
7 6 8 9 10 10 10 8 7 7 6 8 9 8 6 4 3 7 8 6 7 10 7 4 3 4 7 6 3 3 3 3 6 8 10 9 9 3 2 1 
